6 10
|--------|
|GGG|....|
|........|
|GG...@|.|
|..G...|.|
|--------|